map_01
8
7
1 3 1 2 3 1 2 1
2 0 0 0 0 0 0 3
1 0 0 0 0 0 0 1
3 0 0 0 0 0 0 1
2 0 0 0 0 0 0 1
1 0 0 0 0 0 0 3
1 3 2 1 3 2 1 1
